################################
#      #                       #
#   #ud#                       #
#   ####                       #
#   #                          #
# ###                          #
#                #             #
#                #             #
#                #             #
#                              #
# ####                         #
#    #####                     #
#        #                     #
#    #   #                     #
################################