################################
#    s #                       #
#   #ud#                       #
#   ####                       #
#   #                          #
# ###                          #
#                #             #
#                #             #
#                #             #
#    k                         #
# ####                         #
#    #####                     #
#        #                     #
#    #   #                     #
################################