################################
#      #                       #
#   #  #                       #
#   ####                       #
#   #                          #
# ###                          #
#                #             #
#                #             #
#                #             #
#                              #
# ####                         #
#    #####                     #
#        #                     #
#    #   #                     #
################################