################################
#    s #                       #
#   # d#                       #
#   ####                       #
#   #                          #
# ###                          #
#                              #
#                              #
#                              #
#                              #
# ####                         #
#    #####                     #
#        #                     #
#    #   #                     #
################################