################################
#      #                       #
#   #u #                       #
#   ####                       #
#   #                          #
# ###                          #
#                              #
#                              #
#                              #
#                              #
# ####                         #
#    #####                     #
#        #                  s  #
#    #   #                     #
################################