################################
#    s #                       #
#   #u #                       #
#   ####                       #
#   #                          #
# ###                          #
#                              #
#                              #
#                              #
#                              #
# ####                         #
#    #####                     #
#        #                     #
#    #   #                     #
############### ################