################################
#    s #                       #
#   #u #                       #
#   ####    k                  #
#   #                          #
# ###                          #
#                              #
#                              #
#                k             #
#                              #
#k####                         #
#    #####                     #
#        #                     #
#    #   #                     #
################################